NO      textures/wall_1.xpm
SO textures/wall_2.xpm
WE textures/wall_3.xpm
EA textures/wall_4.xpm
F 51,198,11
C 51,198,227

1111111111111111111111111111111111
1000001000000001000000000000000001
1000000000000001000001000000000001
1000000000000000000001000000000001
1111111111111111111111111111111111