NO      textures/wall_1.xpm
SO textures/wall_2.xpm
WE textures/wall_3.xpm
EA textures/wall_4.xpm
F 51,198,11
C 51,198,227

1111111111111111111111111111111111
1000000000000000000000000000000001
1111110111111111011111111D11111101
1000001000000010000001000000000001
100000100010000100000D000000000001
10000000000100000000010000000000W1
1101111111111111111111111111111111
100000001
100000001
111111111
