NO textures/wall_1.xpm
SO textures/wall_2.xpm
WE textures/wall_3.xpm
EA textures/wall_4.xpm
C 51,198,227
F 51,132,0





       1111111111111111111111111111
  111111111000000000000000000000001
1111110111111111011111111011111101
1000001000000010000000100000000001
1000001000100001000001000000000001
10000000000100000000001000000000W1
1101111111111111111111111111111111
100000001
100000001
111111111
