C 51,198, 100

NO      textures/wall_1.xpm
SO    textures/wall_2.xpm

F 51,   198,   100


WE textures/wall_3.xpm




EA textures/wall_4.xpm

1111111111111111111111111111111111
1000000000000000000000000000000001
1111110111111111011111111011111101
1000001000000010000001000000000001
1000001000100001000000000000000001
10000000000100000000010000000000W1
1101111111111111111111111111111111
100000001
100000001
111111111
