NO textures/wall_1.xpm
SO textures/wall_2.xpm
WE textures/wall_3.xpm
EA textures/wall_4.xpm
F 51,198,11
C 51,198,227

11111
11011
11001
10001111
1N000001
11111111
