NO textures/wall_1.xpm
SO textures/wall_2.xpm
WE textures/wall_3.xpm
EA textures/wall_4.xpm
DO textures/bluestone.xpm
A1 textures/window_1.xpm
A2 textures/window_2.xpm
SP textures/bookshelve.xpm 
F 51,198,118
C 51,198,227

1111111111111111111111111111111111
10000000000000000000000000000000P1
111111011111111100000A000000000011
100000100000001100000000000W000001
100000100010000D00P000000000000P01
1000000000010001000000000000000001
1101111111111111111111111111111111
100000001
100000001
111111111